{
    "// 0":  "cell type",
    "// 1":  "north wall texture index / freewall x offset",
    "// 2":  "east wall texture index  / freewall y offset",
    "// 3":  "south wall texture index / freewall width",
    "// 4":  "west wall texture index  / freewall height",
    "// 5":  "static floor texture index",
    "// 6":  "static ceiling texture index",
    "// 7":  "freewall wall texture index    // ------",
    "// 8":  "freewall floor texture index   // FIXME: merge these into 1, 2, 3 and 4",
    "// 9":  "freewall ceiling texture index // ------",
    "// 10": "thing type               / upper wall slope start height",
    "// 11": "thing height             / upper wall slope end height",
    "// 12": "freewall x offset        / lower wall slope start height",
    "// 13": "freewall y offset        / lower wall slope end height",
    "rows": 24,
    "cols": 22,
    "// FIXME": "FIX!!!",
    "map": [
        [1,0,0,0,0,0,1,0,0,0,0,0,0,0,0],[1,0,0,0,0,0,1,0,0,0,0,0,0,0,0],[1,0,0,0,0,0,1,0,0,0,0,0,0,0,0],[1,0,0,0,0,0,1,0,0,0,0,0,0,0,0],[1,0,0,0,0,0,1,0,0,0,0,0,0,0,0],[1,0,0,0,0,0,1,0,0,0,0,0,0,0,0],[1,0,0,0,0,0,1,0,0,0,0,0,0,0,0],[1,0,0,0,0,0,1,0,0,0,0,0,0,0,0],[1,0,0,0,0,0,1,0,0,0,0,0,0,0,0],[1,0,0,4,0,0,1,0,0,0,0,0,0,0,0],[1,0,0,4,0,0,1,0,0,0,0,0,0,0,0],[1,0,0,4,0,0,1,0,0,0,0,0,0,0,0],[1,0,0,4,0,0,1,0,0,0,0,0,0,0,0],[1,0,0,0,0,0,1,0,0,0,0,0,0,0,0],[1,0,0,0,0,0,1,0,0,0,0,0,0,0,0],[1,0,0,0,0,0,1,0,0,0,0,0,0,0,0],[1,0,0,0,0,0,1,0,0,0,0,0,0,0,0],[1,0,0,0,0,0,1,0,0,0,0,0,0,0,0],[1,0,0,0,0,0,1,0,0,0,0,0,0,0,0],[1,0,0,0,0,0,1,0,0,0,0,0,0,0,0],[1,0,0,0,0,0,1,0,0,0,0,0,0,0,0],[1,0,0,0,0,0,1,0,0,0,0,0,0,0,0],
        [1,0,0,0,0,0,1,0,0,0,0,0,0,0,0],[1,0,0,0,0,0,1,0,0,0,0,0,0,0,0],[1,0,0,0,0,0,1,0,0,0,0,0,0,0,0],[1,0,0,0,0,0,1,0,0,0,0,0,0,0,0],[1,0,0,0,0,0,1,0,0,0,0,0,0,0,0],[1,0,0,0,0,0,1,0,0,0,0,0,0,0,0],[1,0,0,0,0,0,1,0,0,0,0,0,0,0,0],[1,0,0,0,0,0,1,0,0,0,0,0,0,0,0],[1,0,4,0,0,0,1,0,0,0,0,0,0,0,0],[2,0,0,0,0,0,1,0,0,0,0,0,0,0,0],[0,0,0,0,0,0,1,0,0,0,0,0,0,0,0],[0,0,0,0,0,0,1,0,0,0,0,0,0,0,0],[2,0,0,0,0,0,1,1,0,0,0,0,0,0,0],[1,0,0,0,4,0,1,0,0,0,0,0,0,0,0],[1,0,0,0,0,0,1,0,0,0,0,0,0,0,0],[1,0,0,0,0,0,1,0,0,0,0,0,0,0,0],[1,0,0,0,0,0,1,0,0,0,0,0,0,0,0],[1,0,0,0,0,0,1,0,0,0,0,0,0,0,0],[7,0,0,10,10,0,1,0,1,1,0,0,1,1,0],[7,0,0,10,10,0,1,0,1,1,0,0,1,1,0],[1,0,0,0,0,0,1,0,0,0,0,0,0,0,0],[1,0,0,0,0,0,1,0,0,0,0,0,0,0,0],
        [1,0,0,0,0,0,1,0,0,0,0,0,0,0,0],[0,0,0,0,0,0,1,0,0,0,0,0,0,0,0],[7,0,0,10,10,0,1,0,1,1,0,0,1,1,0],[7,0,0,10,10,0,1,0,1,1,0,0,1,1,0],[0,0,0,0,0,0,1,0,0,0,0,0,0,0,0],[0,0,0,0,0,0,1,0,0,0,0,0,0,0,0],[1,0,0,0,0,0,1,0,0,0,0,0,0,0,0],[0,0,0,0,0,0,1,0,0,0,0,0,0,0,0],[0,0,0,0,0,0,1,0,0,0,0,0,0,0,0],[0,0,0,0,0,0,1,0,0,0,0,0,0,0,0],[0,0,0,0,0,0,1,0,0,0,0,0,0,0,0],[0,0,0,0,0,0,1,0,0,0,0,0,0,0,0],[0,0,0,0,0,0,1,0,0,0,0,0,0,0,0],[0,0,0,0,0,0,1,0,0,0,0,0,0,0,0],[0,0,0,0,0,0,1,0,0,0,0,0,0,0,0],[1,0,0,2,2,0,1,0,0,0,0,0,0,0,0],[1,3,3,3,0,0,1,0,0,0,0,0,0,0,0],[0,0,0,0,0,0,1,0,0,0,0,0,0,0,0],[7,0,0,10,10,0,1,0,1,1,0,0,1,1,0],[7,0,0,10,10,0,1,0,1,1,0,0,1,1,0],[0,0,0,0,0,0,1,0,0,0,0,0,0,0,0],[1,0,0,0,0,0,1,0,0,0,0,0,0,0,0],
        [1,0,0,0,0,0,1,0,0,0,0,0,0,0,0],[0,0,0,0,0,0,1,0,0,0,0,0,0,0,0],[7,0,0,10,10,0,1,0,1,1,0,0,1,1,0],[7,0,0,10,10,0,1,0,1,1,0,0,1,1,0],[0,0,0,0,0,0,1,0,0,0,0,0,0,0,0],[0,0,0,0,0,0,1,0,0,0,0,0,0,0,0],[7,0,0,10,10,0,1,0,1,3,10,0,0,0,1],[0,0,0,0,0,0,1,0,0,0,0,0,0,0,0],[0,0,0,0,0,0,1,0,0,0,0,0,0,0,0],[0,0,0,0,0,0,1,0,0,0,0,0,0,0,0],[0,0,0,0,0,0,1,0,0,0,0,0,0,0,0],[0,0,0,0,0,0,1,0,0,0,0,0,0,0,0],[0,0,0,0,0,0,1,0,0,0,0,0,0,0,0],[0,0,0,0,0,0,1,0,0,0,0,0,0,0,0],[0,0,0,0,0,0,1,0,0,0,0,0,0,0,0],[0,0,0,0,0,0,1,0,0,0,0,0,0,0,0],[1,3,3,3,0,0,1,0,0,0,0,0,0,0,0],[0,0,0,0,0,0,1,0,0,0,0,0,0,0,0],[7,0,0,10,10,0,1,0,1,1,0,0,1,1,0],[7,0,0,10,10,0,1,0,1,1,0,0,1,1,0],[0,0,0,0,0,0,1,0,0,0,0,0,0,0,0],[1,0,0,0,0,0,1,0,0,0,0,0,0,0,0],
        [1,0,0,0,0,0,1,0,0,0,0,0,0,0,0],[0,0,0,0,0,0,1,0,0,0,0,0,0,0,0],[7,0,0,10,10,0,1,0,1,1,0,0,1,1,0],[7,0,0,10,10,0,1,0,1,1,0,0,1,1,0],[0,0,0,0,0,0,1,0,0,0,0,0,0,0,0],[0,0,0,0,0,0,1,0,0,0,0,0,0,0,0],[0,0,0,0,0,0,1,0,0,0,0,0,0,0,0],[0,0,0,0,0,0,1,0,0,0,0,0,0,0,0],[0,0,0,0,0,0,1,0,0,0,0,0,0,0,0],[7,4,0,2,10,0,1,0,1,3,5,0,5,0,1],[0,0,0,0,0,0,1,0,0,0,0,0,0,0,0],[6,0,0,0,0,3,1,0,0,0,0,10,0,0,0],[0,0,0,0,0,0,1,0,0,0,0,0,0,0,0],[0,0,0,0,0,0,1,0,0,0,0,0,0,0,0],[0,0,0,0,0,0,1,0,0,0,0,0,0,0,0],[7,9,3,1,4,0,1,5,0,2,1,1,0,0,0],[3,0,0,0,0,2,1,0,0,0,0,0,0,0,0],[0,0,0,0,0,0,1,0,0,0,0,0,0,0,0],[7,0,0,10,10,0,1,0,1,1,0,0,1,1,0],[7,0,0,10,10,0,1,0,1,1,0,0,1,1,0],[0,0,0,0,0,0,1,0,0,0,0,0,0,0,0],[1,0,0,0,0,0,1,0,0,0,0,0,0,0,0],
        [1,0,0,0,0,0,1,0,0,0,0,0,0,0,0],[0,0,0,0,0,0,1,0,0,0,0,0,0,0,0],[7,0,0,10,10,0,1,0,1,1,0,0,1,1,0],[7,0,0,10,10,0,1,0,1,1,0,0,1,1,0],[0,0,0,0,0,0,1,0,0,0,0,0,0,0,0],[0,0,0,0,0,0,1,0,0,0,0,0,0,0,0],[7,0,0,10,10,0,1,0,1,3,2,8,6,0,1],[0,0,0,0,0,0,1,0,0,0,0,0,0,0,0],[0,0,0,0,0,0,1,0,0,0,0,0,0,0,0],[7,4,0,2,10,0,1,0,1,3,0,5,0,5,1],[0,0,0,0,0,0,1,0,0,0,0,0,0,0,0],[6,0,0,0,0,0,1,0,0,0,2,10,0,0,0],[0,0,0,0,0,0,1,0,0,0,0,0,0,0,0],[0,0,0,0,0,0,1,0,0,0,0,0,0,0,0],[0,0,0,0,0,0,1,0,0,0,0,0,0,0,0],[0,0,0,0,0,0,1,0,0,0,0,0,0,0,0],[1,3,3,3,0,0,1,0,0,0,0,0,0,0,0],[0,0,0,0,0,0,1,0,0,0,0,0,0,0,0],[7,0,0,10,10,0,1,0,1,1,0,0,1,1,0],[7,0,0,10,10,0,1,0,1,1,0,0,1,1,0],[0,0,0,0,0,0,1,0,0,0,0,0,0,0,0],[1,0,0,0,0,0,1,0,0,0,0,0,0,0,0],
        [1,0,0,0,0,0,1,0,0,0,0,0,0,0,0],[0,0,0,0,0,0,1,0,0,0,0,0,0,0,0],[7,0,0,10,10,0,1,0,1,1,0,0,1,1,0],[7,0,0,10,10,0,1,0,1,1,0,0,1,1,0],[0,0,0,0,0,0,1,0,0,0,0,0,0,0,0],[0,0,0,0,0,0,1,0,0,0,0,0,0,0,0],[1,0,0,0,0,0,1,0,0,0,0,0,0,0,0],[0,0,0,0,0,0,1,0,0,0,0,0,0,0,0],[0,0,0,0,0,0,1,0,0,0,0,0,0,0,0],[0,0,0,0,0,0,1,0,0,0,0,0,0,0,0],[0,0,0,0,0,0,1,0,0,0,0,0,0,0,0],[0,0,0,0,0,0,1,0,0,0,0,0,0,0,0],[0,0,0,0,0,0,1,0,0,0,0,0,0,0,0],[0,0,0,0,0,0,1,0,0,0,0,0,0,0,0],[0,0,0,0,0,0,1,0,0,0,0,0,0,0,0],[1,2,0,0,2,0,1,0,0,0,0,0,0,0,0],[1,3,3,3,0,0,1,0,0,0,0,0,0,0,0],[0,0,0,0,0,0,1,0,0,0,0,0,0,0,0],[7,0,0,10,10,0,1,0,1,1,0,0,1,1,0],[7,0,0,10,10,0,1,0,1,1,0,0,1,1,0],[0,0,0,0,0,0,1,0,0,0,0,0,0,0,0],[1,0,0,0,0,0,1,0,0,0,0,0,0,0,0],
        [1,0,0,0,0,0,1,0,0,0,0,0,0,0,0],[0,0,0,0,0,0,1,0,0,0,0,0,0,0,0],[7,0,0,10,10,0,1,0,1,1,0,0,1,1,0],[7,0,0,10,10,0,1,0,1,1,0,0,1,1,0],[0,0,0,0,0,0,1,0,0,0,0,0,0,0,0],[0,0,0,0,0,0,1,0,0,0,0,0,0,0,0],[1,0,0,0,0,0,1,0,0,0,0,0,0,0,0],[1,0,0,0,0,0,1,0,0,0,0,0,0,0,0],[1,0,0,0,0,0,1,0,0,0,0,0,0,0,0],[1,0,0,0,0,0,1,0,0,0,0,0,0,0,0],[1,0,0,0,0,0,1,0,0,0,0,0,0,0,0],[1,0,0,0,0,0,1,0,0,0,0,0,0,0,0],[1,0,0,0,0,0,1,0,0,0,0,0,0,0,0],[1,0,0,0,0,0,1,0,0,0,0,0,0,0,0],[1,0,0,0,0,0,1,0,0,0,0,0,0,0,0],[1,0,0,0,0,0,1,0,0,0,0,0,0,0,0],[0,0,0,0,0,0,1,0,0,0,0,0,0,0,0],[0,0,0,0,0,0,1,0,0,0,0,0,0,0,0],[7,0,0,10,10,0,1,0,1,1,0,0,1,1,0],[7,0,0,10,10,0,1,0,1,1,0,0,1,1,0],[0,0,0,0,0,0,1,0,0,0,0,0,0,0,0],[1,0,0,0,0,0,1,0,0,0,0,0,0,0,0],
        [1,0,0,0,0,0,1,0,0,0,0,0,0,0,0],[0,0,0,0,0,0,1,0,0,0,0,0,0,0,0],[7,0,0,10,10,0,1,0,1,1,0,0,1,1,0],[7,0,0,10,10,0,1,0,1,1,0,0,1,1,0],[0,0,0,0,0,0,1,0,0,0,0,0,0,0,0],[0,0,0,0,0,0,1,0,0,0,0,0,0,0,0],[7,0,0,10,10,0,1,0,0,3,2,1,7,8,0],[7,0,0,10,10,0,0,0,1,0,0,0,4,4,0],[7,0,0,10,10,0,0,0,1,0,0,0,4,4,0],[7,0,0,10,10,0,0,0,1,0,0,0,4,4,0],[7,0,0,10,10,0,0,0,1,0,0,0,4,4,0],[7,0,0,10,10,0,0,0,1,0,0,0,4,4,0],[7,0,0,10,10,0,0,0,1,0,0,0,4,4,0],[7,0,0,10,10,0,0,0,1,0,0,0,4,4,0],[7,0,0,10,10,0,0,0,1,0,0,0,4,4,0],[1,0,0,0,0,0,1,0,0,0,0,0,0,0,0],[0,0,0,0,0,0,1,0,0,0,0,0,0,0,0],[0,0,0,0,0,0,1,0,0,0,0,0,0,0,0],[7,0,0,10,10,0,1,0,1,1,0,0,1,1,0],[7,0,0,10,10,0,1,0,1,1,0,0,1,1,0],[0,0,0,0,0,0,1,0,0,0,0,0,0,0,0],[1,0,0,0,0,0,1,0,0,0,0,0,0,0,0],
        [1,0,0,0,0,0,1,0,0,0,0,0,0,0,0],[0,0,0,0,0,0,1,0,0,0,0,0,0,0,0],[7,0,0,10,10,0,1,0,1,1,0,0,1,1,0],[7,0,0,10,10,0,1,0,1,1,0,0,1,1,0],[0,0,0,0,0,0,1,0,0,0,0,0,0,0,0],[0,0,0,0,0,0,1,0,0,0,0,0,0,0,0],[1,0,0,0,0,0,1,0,0,0,0,0,0,0,0],[7,0,0,10,10,0,0,0,1,0,0,0,4,4,0],[7,0,0,10,10,0,0,0,1,0,0,0,4,4,0],[7,0,0,10,10,0,0,0,1,0,0,0,4,4,0],[7,0,0,10,10,4,0,8,1,0,0,0,4,4,0],[7,0,0,10,10,0,0,8,1,0,0,0,4,4,0],[7,0,0,10,10,0,0,0,1,0,0,0,4,4,0],[7,0,0,10,10,0,0,0,1,0,0,0,4,4,0],[7,0,0,10,10,0,0,0,1,0,0,0,4,4,0],[1,0,0,0,0,0,1,0,0,0,0,0,0,0,0],[0,0,0,0,0,0,1,0,0,0,0,0,0,0,0],[0,0,0,0,0,0,1,0,0,0,0,0,0,0,0],[7,0,0,10,10,0,1,0,1,1,0,0,1,1,0],[7,0,0,10,10,0,1,0,1,1,0,0,1,1,0],[0,0,0,0,0,0,1,0,0,0,0,0,0,0,0],[1,0,0,0,0,0,1,0,0,0,0,0,0,0,0],
        [1,0,0,0,0,0,1,0,0,0,0,0,0,0,0],[0,0,0,0,0,0,1,0,0,0,0,0,0,0,0],[7,0,0,10,10,0,1,0,1,1,0,0,1,1,0],[7,0,0,10,10,0,1,0,1,1,0,0,1,1,0],[7,0,0,10,10,0,1,6,1,1,0,0,2,2,0],[1,0,0,0,0,0,1,0,0,0,0,0,0,0,0],[1,0,0,0,0,0,1,0,0,0,0,0,0,0,0],[7,0,0,10,10,0,0,0,1,0,0,0,4,4,0],[7,0,0,10,10,0,0,0,1,0,0,0,4,4,0],[1,0,0,0,0,0,0,0,0,0,0,0,0,0,0],[7,0,0,10,10,4,0,0,0,3,1,1,0,0,0],[7,0,0,10,10,4,0,0,0,3,1,1,0,0,0],[1,0,0,0,0,0,0,0,0,0,0,0,0,0,0],[7,0,0,10,10,0,0,0,1,0,0,0,4,4,0],[7,0,0,10,10,0,0,0,1,0,0,0,4,4,0],[1,0,0,0,0,0,1,0,0,0,0,0,0,0,0],[1,0,0,0,0,0,1,0,0,0,0,0,0,0,0],[7,0,0,10,10,0,1,6,1,1,0,0,2,2,0],[7,0,0,10,10,0,1,0,1,1,0,0,1,1,0],[7,0,0,10,10,0,1,0,1,1,0,0,1,1,0],[0,0,0,0,0,0,1,0,0,0,0,0,0,0,0],[1,0,0,0,0,0,1,0,0,0,0,0,0,0,0],
        [1,0,0,0,0,0,1,0,0,0,0,0,0,0,0],[0,0,0,0,0,0,1,0,0,0,0,0,0,0,0],[7,0,0,10,10,0,1,0,1,1,0,0,1,1,0],[7,0,0,10,10,0,1,0,1,1,0,0,1,1,0],[7,0,0,10,10,0,1,6,1,1,0,0,2,2,0],[7,0,0,10,10,0,1,6,1,1,0,0,3,3,0],[7,0,0,10,10,0,1,6,1,3,1,1,4,4,0],[7,0,0,10,10,0,0,0,1,0,0,0,4,4,0],[7,0,0,10,10,0,0,8,1,0,0,0,4,4,0],[7,0,0,10,10,4,0,0,0,3,2,1,0,0,1],[0,0,0,0,0,4,0,0,0,0,0,0,0,0,0],[0,0,0,0,0,4,0,0,0,0,0,0,0,0,0],[7,0,0,10,10,4,0,0,0,3,2,1,0,0,1],[7,0,0,10,10,0,0,8,1,0,0,0,4,4,0],[7,0,0,10,10,0,0,0,1,0,0,0,4,4,0],[7,0,0,10,10,0,1,6,1,3,1,1,4,4,0],[7,0,0,10,10,0,1,6,1,1,0,0,3,3,0],[7,0,0,10,10,0,1,6,1,1,0,0,2,2,0],[7,0,0,10,10,0,1,0,1,1,0,0,1,1,0],[7,0,0,10,10,0,1,0,1,1,0,0,1,1,0],[0,0,0,0,0,0,1,0,0,0,0,0,0,0,0],[1,0,0,0,0,0,1,0,0,0,0,0,0,0,0],
        [1,0,0,0,0,0,1,0,0,0,0,0,0,0,0],[0,0,0,0,0,0,1,0,0,0,0,0,0,0,0],[7,0,0,10,10,0,1,0,1,1,0,0,1,1,0],[7,0,0,10,10,0,1,0,1,1,0,0,1,1,0],[7,0,0,10,10,0,1,6,1,1,0,0,2,2,0],[7,0,0,10,10,0,1,6,1,1,0,0,3,3,0],[7,0,0,10,10,0,1,6,1,3,1,1,4,4,0],[7,0,0,10,10,0,0,0,1,0,0,0,4,4,0],[7,0,0,10,10,0,0,8,1,0,0,0,4,4,0],[7,0,0,10,10,4,0,0,0,3,1,2,0,0,1],[0,0,0,0,0,4,0,0,0,0,0,0,0,0,0],[0,0,0,0,0,4,0,0,0,0,0,0,0,0,0],[7,0,0,10,10,4,0,0,0,3,1,2,0,0,1],[7,0,0,10,10,0,0,8,1,0,0,0,4,4,0],[7,0,0,10,10,0,0,0,1,0,0,0,4,4,0],[7,0,0,10,10,0,1,6,1,3,1,1,4,4,0],[7,0,0,10,10,0,1,6,1,1,0,0,3,3,0],[7,0,0,10,10,0,1,6,1,1,0,0,2,2,0],[7,0,0,10,10,0,1,0,1,1,0,0,1,1,0],[7,0,0,10,10,0,1,0,1,1,0,0,1,1,0],[0,0,0,0,0,0,1,0,0,0,0,0,0,0,0],[1,0,0,0,0,0,1,0,0,0,0,0,0,0,0],
        [1,0,0,0,0,0,1,0,0,0,0,0,0,0,0],[0,0,0,0,0,0,1,0,0,0,0,0,0,0,0],[7,0,0,10,10,0,1,0,1,1,0,0,1,1,0],[7,0,0,10,10,0,1,0,1,1,0,0,1,1,0],[7,0,0,10,10,0,1,6,1,1,0,0,2,2,0],[1,0,0,0,0,0,1,0,0,0,0,0,0,0,0],[1,0,0,0,0,0,1,0,0,0,0,0,0,0,0],[7,0,0,10,10,0,0,0,1,0,0,0,4,4,0],[7,0,0,10,10,0,0,0,1,0,0,0,4,4,0],[1,0,0,0,0,0,0,0,0,0,0,0,0,0,0],[7,0,0,10,10,4,0,0,0,3,1,1,0,0,0],[7,0,0,10,10,4,0,0,0,3,1,1,0,0,0],[1,0,0,0,0,0,0,0,0,0,0,0,0,0,0],[7,0,0,10,10,0,0,0,1,0,0,0,4,4,0],[7,0,0,10,10,0,0,0,1,0,0,0,4,4,0],[1,0,0,0,0,0,1,0,0,0,0,0,0,0,0],[1,0,0,0,0,0,1,0,0,0,0,0,0,0,0],[7,0,0,10,10,0,1,6,1,1,0,0,2,2,0],[7,0,0,10,10,0,1,0,1,1,0,0,1,1,0],[7,0,0,10,10,0,1,0,1,1,0,0,1,1,0],[0,0,0,0,0,0,1,0,0,0,0,0,0,0,0],[1,0,0,0,0,0,1,0,0,0,0,0,0,0,0],
        [1,0,0,0,0,0,1,0,0,0,0,0,0,0,0],[0,0,0,0,0,0,1,0,0,0,0,0,0,0,0],[7,0,0,10,10,0,1,0,1,1,0,0,1,1,0],[7,0,0,10,10,0,1,0,1,1,0,0,1,1,0],[0,0,0,0,0,0,1,0,0,0,0,0,0,0,0],[0,0,0,0,0,0,1,0,0,0,0,0,0,0,0],[1,0,0,0,0,0,1,0,0,0,0,0,0,0,0],[7,0,0,10,10,0,0,0,1,0,0,0,4,4,0],[7,0,0,10,10,0,0,0,1,0,0,0,4,4,0],[7,0,0,10,10,0,0,0,1,0,0,0,4,4,0],[7,0,0,10,10,4,0,8,1,0,0,0,4,4,0],[7,0,0,10,10,0,0,8,1,0,0,0,4,4,0],[7,0,0,10,10,0,0,0,1,0,0,0,4,4,0],[7,0,0,10,10,0,0,0,1,0,0,0,4,4,0],[7,0,0,10,10,0,0,0,1,0,0,0,4,4,0],[1,0,0,0,0,0,1,0,0,0,0,0,0,0,0],[0,0,0,0,0,0,1,0,0,0,0,0,0,0,0],[0,0,0,0,0,0,1,0,0,0,0,0,0,0,0],[7,0,0,10,10,0,1,0,1,1,0,0,1,5,1],[7,0,0,10,10,0,1,0,1,1,0,0,1,5,1],[0,0,0,0,0,0,1,0,0,0,0,0,0,0,0],[1,0,0,0,0,0,1,0,0,0,0,0,0,0,0],
        [1,0,0,0,0,0,1,0,0,0,0,0,0,0,0],[0,0,0,0,0,0,1,0,0,0,0,0,0,0,0],[7,0,0,10,10,0,1,0,1,1,0,0,1,1,0],[7,0,0,10,10,0,1,0,1,1,0,0,1,1,0],[0,0,0,0,0,0,1,0,0,0,0,0,0,0,0],[0,0,0,0,0,0,1,0,0,0,0,0,0,0,0],[7,0,0,10,10,0,1,0,0,3,3,5,6,4,0],[7,0,0,10,10,0,0,0,1,0,0,0,4,4,0],[7,0,0,10,10,0,0,0,1,0,0,0,4,4,0],[7,0,0,10,10,0,0,0,1,0,0,0,4,4,0],[7,0,0,10,10,0,0,0,1,0,0,0,4,4,0],[7,0,0,10,10,0,0,0,1,0,0,0,4,4,0],[7,0,0,10,10,0,0,0,1,0,0,0,4,4,0],[7,0,0,10,10,0,0,0,1,0,0,0,4,4,0],[7,0,0,10,10,0,0,0,1,0,0,0,4,4,0],[1,0,0,0,0,0,1,0,0,0,0,0,0,0,0],[0,0,0,0,0,0,1,0,0,0,0,0,0,0,0],[0,0,0,0,0,0,1,0,0,0,0,0,0,0,0],[7,0,0,10,10,0,1,0,1,1,0,0,5,5,0],[7,0,0,10,10,0,1,0,1,1,0,0,5,5,0],[0,0,0,0,0,0,1,0,0,0,0,0,0,0,0],[1,0,0,0,0,0,1,0,0,0,0,0,0,0,0],
        [1,0,0,0,0,0,1,0,0,0,0,0,0,0,0],[0,0,0,0,0,0,1,0,0,0,0,0,0,0,0],[7,0,0,10,10,0,1,0,1,1,0,0,1,1,0],[7,0,0,10,10,0,1,0,1,1,0,0,1,1,0],[0,0,0,0,0,0,1,0,0,0,0,0,0,0,0],[0,0,0,0,0,0,1,0,0,0,0,0,0,0,0],[1,0,0,0,0,0,1,0,0,0,0,0,0,0,0],[1,0,0,0,0,0,1,0,0,0,0,0,0,0,0],[1,0,0,0,0,0,1,0,0,0,0,0,0,0,0],[1,0,0,0,0,0,1,0,0,0,0,0,0,0,0],[1,0,0,0,0,0,1,0,0,0,0,0,0,0,0],[1,0,0,0,0,0,1,0,0,0,0,0,0,0,0],[1,0,0,0,0,0,1,0,0,0,0,0,0,0,0],[1,0,0,0,0,0,1,0,0,0,0,0,0,0,0],[1,0,0,0,0,0,1,0,0,0,0,0,0,0,0],[1,0,0,0,0,0,1,0,0,0,0,0,0,0,0],[0,0,0,0,0,0,1,0,0,0,0,0,0,0,0],[0,0,0,0,0,0,1,0,0,0,0,0,0,0,0],[7,0,0,10,10,0,1,0,1,1,0,0,5,3,1],[7,0,0,10,10,0,1,0,1,1,0,0,5,3,1],[0,0,0,0,0,0,1,0,0,0,0,0,0,0,0],[1,0,0,0,0,0,1,0,0,0,0,0,0,0,0],
        [1,0,0,0,0,0,1,0,0,0,0,0,0,0,0],[0,0,0,0,0,0,1,0,0,0,0,0,0,0,0],[7,0,0,10,10,0,1,0,1,1,0,0,1,1,0],[7,0,0,10,10,0,1,0,1,1,0,0,1,1,0],[0,0,0,0,0,0,1,0,0,0,0,0,0,0,0],[1,3,0,3,3,0,1,0,0,0,0,0,0,0,0],[1,0,2,2,0,0,1,0,0,0,0,0,0,0,0],[0,0,0,0,0,0,1,0,0,0,0,0,0,0,0],[0,0,0,0,0,0,1,0,0,0,0,0,0,0,0],[0,0,0,0,0,0,1,0,0,0,0,0,0,0,0],[0,0,0,0,0,0,1,0,0,0,0,0,0,0,0],[0,0,0,0,0,0,1,0,0,0,0,0,0,0,0],[0,0,0,0,0,0,1,0,0,0,0,0,0,0,0],[0,0,0,0,0,0,1,0,0,0,0,0,0,0,0],[0,0,0,0,0,0,1,0,0,0,0,0,0,0,0],[0,0,0,0,0,0,1,0,0,0,0,0,0,0,0],[0,0,0,0,0,0,1,0,0,0,0,0,0,0,0],[0,0,0,0,0,0,1,0,0,0,0,0,0,0,0],[7,0,0,10,10,0,1,0,1,1,0,0,3,1,1],[7,0,0,10,10,0,1,0,1,1,0,0,3,1,1],[0,0,0,0,0,0,1,0,0,0,0,0,0,0,0],[1,0,0,0,0,0,1,0,0,0,0,0,0,0,0],
        [1,0,0,0,0,0,1,0,0,0,0,0,0,0,0],[0,0,0,0,0,0,1,0,0,0,0,0,0,0,0],[7,0,0,10,10,0,1,0,1,1,0,0,1,1,0],[7,0,0,10,10,0,1,0,1,1,0,0,1,1,0],[0,0,0,0,0,0,1,0,0,0,0,0,0,0,0],[1,3,0,2,3,0,1,0,0,0,0,0,0,0,0],[0,0,0,0,0,0,1,0,0,0,0,0,0,0,0],[0,0,0,0,0,0,1,0,0,0,0,0,0,0,0],[0,0,0,0,0,0,1,0,0,0,0,0,0,0,0],[0,0,0,0,0,0,1,0,0,0,0,0,0,0,0],[0,0,0,0,0,0,1,0,0,0,0,0,0,0,0],[0,0,0,0,0,0,1,0,0,0,0,0,0,0,0],[0,0,0,0,0,0,1,0,0,0,0,0,0,0,0],[0,0,0,0,0,0,1,0,0,0,0,0,0,0,0],[0,0,0,0,0,0,1,0,0,0,0,0,0,0,0],[0,0,0,0,0,0,1,0,0,0,0,0,0,0,0],[0,0,0,0,0,0,1,0,0,0,0,0,0,0,0],[0,0,0,0,0,0,1,0,0,0,0,0,0,0,0],[7,0,0,10,10,0,1,0,1,1,0,0,1,1,0],[7,0,0,10,10,0,1,0,1,1,0,0,1,1,0],[0,0,0,0,0,0,1,0,0,0,0,0,0,0,0],[1,0,0,0,0,0,1,0,0,0,0,0,0,0,0],
        [1,0,0,0,0,0,1,0,0,0,0,0,0,0,0],[0,0,0,0,0,0,1,0,0,0,0,0,0,0,0],[7,0,0,10,10,0,1,0,1,1,0,0,1,1,0],[7,0,0,10,10,0,1,0,1,1,0,0,1,1,0],[7,9,3,1,4,0,1,5,0,2,1,1,0,0,0],[3,0,0,0,0,2,1,0,0,0,0,0,0,0,0],[0,0,0,0,0,0,1,0,0,0,0,0,0,0,0],[0,0,0,0,0,0,1,0,0,0,0,0,0,0,0],[0,0,0,0,0,0,1,0,0,0,0,0,0,0,0],[0,0,0,0,0,0,1,0,0,0,0,0,0,0,0],[2,0,0,0,0,0,1,3,0,0,0,0,0,0,0],[2,0,0,0,0,0,1,2,0,0,0,0,0,0,0],[0,0,0,0,0,0,1,0,0,0,0,0,0,0,0],[0,0,0,0,0,0,1,0,0,0,0,0,0,0,0],[0,0,0,0,0,0,1,0,0,0,0,0,0,0,0],[0,0,0,0,0,0,1,0,0,0,0,0,0,0,0],[0,0,0,0,0,0,1,0,0,0,0,0,0,0,0],[0,0,0,0,0,0,1,0,0,0,0,0,0,0,0],[7,0,0,10,10,0,1,0,1,1,0,0,1,3,1],[7,0,0,10,10,0,1,0,1,1,0,0,1,3,1],[0,0,0,0,0,0,1,0,0,0,0,0,0,0,0],[1,0,0,0,0,0,1,0,0,0,0,0,0,0,0],
        [1,0,0,0,0,0,1,0,0,0,0,0,0,0,0],[7,0,7,10,3,0,1,0,0,2,1,1,3,3,0],[7,0,7,3,3,0,1,0,0,2,1,1,3,3,0],[7,0,0,10,10,0,1,0,1,1,0,0,1,1,0],[0,0,0,0,0,0,1,0,0,0,0,0,0,0,0],[1,2,0,3,3,0,1,0,0,0,0,0,0,0,0],[0,0,0,0,0,0,1,0,0,0,0,0,0,0,0],[0,0,0,0,0,0,1,0,0,0,0,0,0,0,0],[0,0,0,0,0,0,1,0,0,0,0,0,0,0,0],[0,0,0,0,0,0,1,0,0,0,0,0,0,0,0],[0,0,0,0,0,0,1,0,0,0,0,0,0,0,0],[0,0,0,0,0,0,1,0,0,0,0,0,0,0,0],[0,0,0,0,0,0,1,0,0,0,0,0,0,0,0],[0,0,0,0,0,0,1,0,0,0,0,0,0,0,0],[0,0,0,0,0,0,1,0,0,0,0,0,0,0,0],[0,0,0,0,0,0,1,0,0,0,0,0,0,0,0],[0,0,0,0,0,0,1,0,0,0,0,0,0,0,0],[0,0,0,0,0,0,1,0,0,0,0,0,0,0,0],[7,0,0,10,10,0,1,0,1,1,0,0,3,3,0],[7,0,0,10,10,0,1,0,1,1,0,0,3,3,0],[0,0,0,0,0,0,1,0,0,0,0,0,0,0,0],[1,0,0,0,0,0,1,0,0,0,0,0,0,0,0],
        [1,0,0,0,0,0,1,0,0,0,0,0,0,0,0],[7,2,2,6,6,0,1,7,0,2,2,2,6,6,0],[7,0,0,3,10,0,1,0,0,2,1,1,3,3,0],[7,0,0,10,10,0,1,0,1,1,0,0,1,1,0],[0,0,0,0,0,0,1,0,0,0,0,0,0,0,0],[1,3,0,3,3,0,1,0,0,0,0,0,0,0,0],[1,2,2,0,0,0,1,0,0,0,0,0,0,0,0],[0,0,0,0,0,0,1,0,0,0,0,0,0,0,0],[0,0,0,0,0,0,1,0,0,0,0,0,0,0,0],[0,0,0,0,0,0,1,0,0,0,0,0,0,0,0],[0,0,0,0,0,0,1,0,0,0,0,0,0,0,0],[0,0,0,0,0,0,1,0,0,0,0,0,0,0,0],[0,0,0,0,0,0,1,0,0,0,0,0,0,0,0],[0,0,0,0,0,0,1,0,0,0,0,0,0,0,0],[0,0,0,0,0,0,1,0,0,0,0,0,0,0,0],[0,0,0,0,0,0,1,0,0,0,0,0,0,0,0],[0,0,0,0,0,0,1,0,0,0,0,0,0,0,0],[0,0,0,0,0,0,1,0,0,0,0,0,0,0,0],[7,0,0,10,10,0,1,0,1,1,0,0,3,5,1],[7,0,0,10,10,0,1,0,1,1,0,0,3,5,1],[0,0,0,0,0,0,1,0,0,0,0,0,0,0,0],[1,0,0,0,0,0,1,0,0,0,0,0,0,0,0],
        [1,0,0,0,0,0,1,0,0,0,0,0,0,0,0],[1,0,0,0,0,0,1,0,0,0,0,0,0,0,0],[1,0,0,0,0,0,1,0,0,0,0,0,0,0,0],[1,0,0,0,0,0,1,0,0,0,0,0,0,0,0],[1,0,0,0,0,0,1,0,0,0,0,0,0,0,0],[1,0,0,0,0,0,1,0,0,0,0,0,0,0,0],[1,0,0,0,0,0,1,0,0,0,0,0,0,0,0],[1,0,0,0,0,0,1,0,0,0,0,0,0,0,0],[1,0,4,0,0,0,1,0,0,0,0,0,0,0,0],[2,0,0,0,0,0,1,3,0,0,0,0,0,0,0],[6,0,0,0,0,0,1,0,0,0,1,10,0,0,0],[0,0,0,0,0,0,1,0,0,0,0,0,0,0,0],[2,0,0,0,0,0,1,2,0,0,0,0,0,0,0],[1,0,0,0,4,0,1,0,0,0,0,0,0,0,0],[1,0,0,0,0,0,1,0,0,0,0,0,0,0,0],[1,0,0,0,0,0,1,0,0,0,0,0,0,0,0],[1,0,0,0,0,0,1,0,0,0,0,0,0,0,0],[1,0,0,0,0,0,1,0,0,0,0,0,0,0,0],[1,0,0,0,0,0,1,0,0,0,0,0,0,0,0],[1,0,0,0,0,0,1,0,0,0,0,0,0,0,0],[1,0,0,0,0,0,1,0,0,0,0,0,0,0,0],[1,0,0,0,0,0,1,0,0,0,0,0,0,0,0],
        [1,0,0,0,0,0,1,0,0,0,0,0,0,0,0],[1,0,0,0,0,0,1,0,0,0,0,0,0,0,0],[1,0,0,0,0,0,1,0,0,0,0,0,0,0,0],[1,0,0,0,0,0,1,0,0,0,0,0,0,0,0],[1,0,0,0,0,0,1,0,0,0,0,0,0,0,0],[1,0,0,0,0,0,1,0,0,0,0,0,0,0,0],[1,0,0,0,0,0,1,0,0,0,0,0,0,0,0],[1,0,0,0,0,0,1,0,0,0,0,0,0,0,0],[1,0,0,0,0,0,1,0,0,0,0,0,0,0,0],[1,4,0,0,0,0,1,0,0,0,0,0,0,0,0],[1,4,0,0,0,0,1,0,0,0,0,0,0,0,0],[1,4,0,0,0,0,1,0,0,0,0,0,0,0,0],[1,4,0,0,0,0,1,0,0,0,0,0,0,0,0],[1,0,0,0,0,0,1,0,0,0,0,0,0,0,0],[1,0,0,0,0,0,1,0,0,0,0,0,0,0,0],[1,0,0,0,0,0,1,0,0,0,0,0,0,0,0],[1,0,0,0,0,0,1,0,0,0,0,0,0,0,0],[1,0,0,0,0,0,1,0,0,0,0,0,0,0,0],[1,0,0,0,0,0,1,0,0,0,0,0,0,0,0],[1,0,0,0,0,0,1,0,0,0,0,0,0,0,0],[1,0,0,0,0,0,1,0,0,0,0,0,0,0,0],[1,0,0,0,0,0,1,0,0,0,0,0,0,0,0]
    ],
    "sprites": [],
    "tracks": []
}
